1 1 1 1 1 1 1 1 1 1 1 1 1 1 1 1 1 1 1 1 1 1 1 1 1 1 1 1 1 1 1 1 1 1 1 1 1 1 1 1
1 2 2 2 2 2 2 2 1 6 6 6 6 6 6 6 6 6 6 6 6 6 6 6 6 6 6 6 6 6 6 1 2 2 2 2 2 2 2 1
1 2 2 2 2 2 2 2 1 6 6 6 6 6 6 6 6 6 6 6 6 6 6 6 6 6 6 6 6 6 6 1 2 2 2 2 2 2 2 1
1 2 2 2 2 2 2 2 1 6 6 6 6 6 6 6 6 6 6 6 6 6 6 6 6 6 6 6 6 6 6 1 2 2 2 2 2 2 2 1
1 2 2 2 2 2 2 2 1 6 6 6 6 6 6 6 6 6 6 6 6 6 6 6 6 6 6 6 6 6 6 1 2 2 2 2 2 2 2 1
1 2 2 2 2 2 2 2 1 6 6 6 6 6 6 6 6 6 6 6 6 6 6 6 6 6 6 6 6 6 6 1 2 2 2 2 2 2 2 1
1 2 2 2 2 2 2 2 1 6 6 6 6 6 6 6 6 6 6 6 6 6 6 6 6 6 6 6 6 6 6 1 2 2 2 2 2 2 2 1
1 2 2 2 2 2 2 2 1 1 1 1 1 1 1 1 1 9 8 7 1 1 1 1 1 1 1 1 1 1 1 1 1 1 1 1 5 1 1 1
1 2 2 2 2 2 2 2 1 0 0 0 0 0 1 3 3 3 3 3 3 3 3 3 3 1 0 0 0 0 0 0 0 1 2 2 2 2 2 1
1 2 2 2 2 2 2 2 4 0 0 0 0 0 1 3 3 3 3 3 3 3 3 3 3 1 0 0 0 0 0 0 0 1 2 2 2 2 2 1
1 2 2 2 2 2 2 2 1 0 0 0 0 0 4 3 3 3 3 3 3 3 3 3 3 1 0 0 0 0 0 0 0 1 2 2 2 2 2 1
1 1 1 5 1 1 1 1 1 0 0 0 0 0 1 3 3 3 3 3 3 3 3 3 3 1 0 0 0 0 0 0 0 1 2 2 2 2 2 1
1 2 2 2 2 2 1 0 0 0 0 0 0 0 1 3 3 3 3 3 3 3 3 3 3 1 0 0 0 0 0 0 0 1 2 2 2 2 2 1
1 2 2 2 2 2 1 0 0 0 0 0 0 0 1 1 1 1 1 5 1 1 1 1 1 1 0 0 0 0 0 0 0 1 2 2 2 2 2 1
1 2 2 2 2 2 1 0 0 0 0 0 0 0 0 0 0 1 3 3 3 3 1 0 0 0 0 0 0 0 0 0 0 4 2 2 2 2 2 1
1 2 2 2 2 2 4 0 0 0 0 0 0 0 0 0 0 1 3 3 3 3 1 0 0 0 0 0 0 0 0 0 0 1 2 2 2 2 2 1
1 2 2 2 2 2 1 0 0 0 0 0 0 0 0 0 0 1 3 3 3 3 1 0 0 0 0 0 0 0 0 0 0 1 2 2 2 2 2 1
1 2 2 2 2 2 1 0 0 0 0 0 0 0 0 0 0 1 3 3 3 3 1 0 0 0 0 0 0 0 0 0 0 1 2 2 2 2 2 1
1 2 2 2 2 2 1 0 0 0 0 0 0 1 1 1 1 1 1 5 1 1 1 1 1 1 1 0 0 0 0 0 0 1 2 2 2 2 2 1
1 2 2 2 2 2 1 0 0 0 0 0 0 1 3 3 3 3 3 3 3 3 3 3 3 3 1 0 0 0 0 0 0 1 2 2 2 2 2 1
1 2 2 2 2 2 1 1 1 1 1 1 1 1 3 3 3 3 3 3 3 3 3 3 3 3 1 1 1 1 1 1 1 1 2 2 2 2 2 1
1 2 2 2 2 2 4 3 3 3 3 3 3 4 3 3 3 3 3 3 3 3 3 3 3 3 4 3 3 3 3 3 3 4 2 2 2 2 2 1
1 2 2 2 2 2 1 3 3 3 3 3 3 1 3 3 3 3 3 3 3 3 3 3 3 3 1 3 3 3 3 3 3 1 2 2 2 2 2 1
1 2 2 2 2 2 1 1 1 1 1 1 1 1 3 3 3 3 3 3 3 3 3 3 3 3 1 1 1 1 1 1 1 1 2 2 2 2 2 1
1 1 1 5 1 1 1 3 3 3 3 3 3 1 1 1 1 1 1 5 1 1 1 1 1 1 1 3 3 3 3 3 3 1 2 2 2 2 2 1
1 2 2 2 2 2 1 3 3 3 3 3 3 3 3 3 3 3 3 3 3 3 3 3 3 3 3 3 3 3 3 3 3 1 2 2 2 2 2 1
1 2 2 2 2 2 4 3 3 3 3 3 3 3 3 3 3 3 3 3 3 3 3 3 3 3 3 3 3 3 3 3 3 4 2 2 2 2 2 1
1 2 2 2 2 2 1 3 3 3 3 3 3 3 3 3 3 3 3 3 3 3 3 3 3 3 3 3 3 3 3 3 3 1 2 2 2 2 2 1
1 2 2 2 2 2 1 1 1 1 1 1 1 1 1 1 1 1 1 1 1 1 1 1 1 1 1 1 1 1 1 1 1 1 2 2 2 2 2 1
1 2 2 2 2 2 2 2 2 2 2 1 6 6 6 6 6 6 6 6 6 6 6 6 6 6 6 6 4 2 2 2 2 2 2 2 2 2 2 1
1 2 2 2 2 2 2 2 2 2 2 1 6 6 6 6 6 6 6 6 6 6 6 6 6 6 6 6 1 2 2 2 2 2 2 2 2 2 2 1
1 2 2 2 2 2 2 2 2 2 2 1 6 6 6 6 6 6 6 6 6 6 6 6 6 6 6 6 1 1 1 1 1 5 1 1 1 1 1 1
1 2 2 2 2 2 2 2 2 2 2 1 6 6 6 6 6 6 6 6 6 6 6 6 6 6 6 6 1 2 2 2 2 2 2 2 2 2 2 1
1 2 2 2 2 2 2 2 2 2 2 1 6 6 6 6 6 6 6 6 6 6 6 6 6 6 6 6 1 2 2 2 2 2 2 2 2 2 2 1
1 1 5 1 1 1 2 2 2 2 2 1 6 6 6 6 6 6 6 6 6 6 6 6 6 6 6 6 1 2 2 2 2 2 1 1 1 1 1 1
1 0 0 0 0 1 2 2 2 2 2 1 6 6 6 6 6 6 6 6 6 6 6 6 6 6 6 6 1 2 2 2 2 2 1 0 0 0 0 1
1 0 0 0 0 1 1 1 1 1 1 1 6 6 6 6 6 6 6 6 6 6 6 6 6 6 6 6 1 1 1 1 1 1 1 0 0 0 0 1
1 0 0 0 0 0 0 0 0 0 0 1 6 6 6 6 6 6 6 6 6 6 6 6 6 6 6 6 1 0 0 0 0 0 0 0 0 0 0 1
1 0 0 0 0 0 0 0 0 0 0 4 6 6 6 6 6 6 6 6 6 6 6 6 6 6 6 6 4 0 0 0 0 0 0 0 0 0 0 1
1 1 1 1 1 1 1 1 1 1 1 1 1 1 1 1 1 1 1 1 1 1 1 1 1 1 1 1 1 1 1 1 1 1 1 1 1 1 1 1